####o####
#  oo   #
# #o## ##
# #oo# ####
# ##o# #  #
#  #o# #  #
##ooo# # ##
#oo# # # ##
#o##   # ##
#o######oo
#oo#  #oo#
# oooooo #
##########
