        
        
        ###############
        #             #
        #    #####    #
        #    #   #    #
        #    #   #    #
        #    X   X    #
        #    #   #    #
        #    #   #    #
        ######   ######


