###############
#   ooooooo   #
#   o#####o   #
#   o#   #o   #
#   o#   #o   #
#   oo   oo   #
#    #   #    #
#    #   #    #
######   ######
