   
      
    ####X####
    #       #  
    # # ## ##
    # #  # #### 
    # ## # #  #       
    #  # # #  #
    ##   # # ##
    #  # # # ##
    # ##   # ##    
    # ###### X
    #  #  #  #
    #        #  
    ##########
      
                
