        
        
        ###############
        #             #
        #    #####    #
        #    #   #    #
        #### #   #    #
        #  X #   X    #
        #  # #   #    #
        #  # #   #    #
        ######   ######


