        
        
        ###############
        #             #
        #    #####    #
        #    #   #    #
        #    #   #    #
        #    X   X    #
        #    # # #    #
        #    # # #    #
        ######   ######


